-1 25 21 21 21 21 21 21 21 21 17 21 21 21 21 21 21 21 21 19 -1
-1 26  0  0  0  0  0  0  0  0 26  0  0  0  0  0  0  0  0 26 -1
-1 26  0 29 23  0 29 21 23  0 30  0 29 21 23  0 29 23  0 26 -1
-1 26  0  0  0  0  0  0  0  0  0  0  0  0  0  0  0  0  0 26 -1
-1 26  0 29 23  0 27  0 29 21 17 21 23  0 27  0 29 23  0 26 -1
-1 26  0  0  0  0 26  0  0  0 26  0  0  0 26  0  0  0  0 26 -1
-1 28 21 21 19  0 24 21 23 -1 30 -1 29 21 18  0 25 21 21 22 -1
-1 -1 -1 -1 26  0 26 -1 -1 -1 -1 -1 -1 -1 26  0 26 -1 -1 -1 -1
21 21 21 21 22  0 30 -1 25 23 -1 29 19 -1 30  0 28 21 21 21 21
-1 -1 -1 -1 -1  0 -1 -1 26 -1 -1 -1 26 -1 -1  0 -1 -1 -1 -1 -1
21 21 21 21 19  0 27 -1 28 21 21 21 22 -1 27  0 25 21 21 21 21
-1 -1 -1 -1 26  0 26 -1 -1 -1 -1 -1 -1 -1 26  0 26 -1 -1 -1 -1
-1 25 21 21 22  0 30 -1 29 21 17 21 23 -1 30  0 28 21 21 19 -1
-1 26  0  0  0  0  0  0  0  0 26  0  0  0  0  0  0  0  0 26 -1
-1 26  0 29 19  0 29 21 23  0 30  0 29 21 23  0 25 23  0 26 -1
-1 26  0  0 26  0  0  0  0  0  0  0  0  0  0  0 26  0  0 26 -1
-1 24 23  0 30  0 27  0 29 21 17 21 23  0 27  0 30  0 29 18 -1
-1 26  0  0  0  0 26  0  0  0 26  0  0  0 26  0  0  0  0 26 -1
-1 26  0 29 21 21 20 21 23  0 30  0 29 21 20 21 21 23  0 26 -1
-1 26  0  0  0  0  0  0  0  0  0  0  0  0  0  0  0  0  0 26 -1
-1 28 21 21 21 21 21 21 21 21 21 21 21 21 21 21 21 21 21 22 -1